15 16
# # # # # # # # # # # # # # # #
# @ * . . . . * * * . . . . . #
# . . . * . . . . . . . * . $ #
# # # # # # # # # # # # # # * #
# . & * * . . . . * . . . . . #
# . . . . . . * * $ . . * . * #
# * # # # # # # # # # # # # # #
# . . * . * $ * . . . $ . . . #
# . . . . . . . . * . * . $ . #
# # # # # # # # # # # # # # * #
# * . & . * . * * & . . * . . #
# . . * . . * . . . * * & . . #
# * # # # # # # # # # # # # # #
# . . . . . . . ! . . . . . & #
# # # # # # # # # # # # # # # #
