18 18
# # # # # # # # # # # # # # # # # #
# @ * . . . . * . * . . . . . # . #
# . . # . . . . # . . . * . . . . #
# . . . # . . $ . . # . . * . * . #
# . * * * . * # # . . $ . . # . . #
# . . . . * # . . . . . . # . . . #
# . * $ . * * # . * # . . * * . . #
# . . . . * # . . . * . . . * & * #
# * * . . . # . . . . # . # # # # #
# * . . * . $ * * . . . * . . & . #
# . . . . . . . . . # . . # * # * #
# * . . * . . # . . . . . # . . * #
# . * . . . # # * * . * # # . . . #
# . . * # # . * . . $ . . * . & . #
# . & * . . . . # # . . . # . . . #
# . . . * * . * . # . . # # . . . #
# # . * . . . ! # . . . . . * . * #
# # # # # # # # # # # # # # # # # #
