17 17
# # # # # # # # # # # # # # # # #
# @ . * * * * * * * * * * * * * #
# . * * * & * * & * * & * * & * #
# * * * * * * * * * * * * * * * #
# * * * * * * * * * * * * * * * #
# * & * * & * * & * * & * * & * #
# * * * * * * * * * * * * * * * #
# * * * * * * * * * * * * * * * #
# * & * * & * * & * * & * * & * #
# * * * * * * * * * * * * * * * #
# * * * * * * * * * * * * * * * #
# * & * * & * * & * * & * * & * #
# * * * * * * * * * * * * * * * #
# * * * * * * * * * * * * * * * #
# * & * * & * * & * * & * * & * #
# * * * * * * * * * * * * * * ! #
# # # # # # # # # # # # # # # # #
