10 12
# # # # # # # # # # # #
# @ . . . # . # . . * #
# . * . . . . . . # . #
# . . * * * * * * . . #
# . . * . . . . * . # #
# . . * & . . ! * . . #
# . . * * * * * * . . #
# $ # $ . . . # . * . #
# * . . . . . # $ . . #
# # # # # # # # # # # #
