12 13
# # # # # # # # # # # # # 
# @ . . . . # . . . . . # 
# . # # # . # . * * * . # 
# . . # . . # . & . . . # 
# # . # . # # * * # # # # 
# # . # . * . . $ # . & # 
# . . # . # . . . # . . # 
# . # # # # # # # # . . # 
# . # $ . . . . . * . . # 
# . # . # # # # # # # * # 
# . . . # ! . . . . . $ # 
# # # # # # # # # # # # # 
