20 20
# # # # # # # # # # # # # # # # # # # #
# @ . . . # * & # # . # # . . . * * $ #
# . . . . . . # . . . # . . . . * * . #
# # # # # * . . . . . . . . # . . . . #
# . . . * * . # # # # # . # . . . . . #
# $ * . . . # # . . . . . # # # # # # #
# * * . . # & . . . * . . . . * * . . #
# . . . . * # . . * # * . . . * * . . #
# . # # # . # * . . * & # . . . . . . #
# . . $ # . . * . . . # . * . . * * . #
# . . . . . . * . . . . . . . * * * $ #
# # # # # # # # . ! . # # # # # $ . # #
# . . . . . . * . . . . . . . . . . . #
# * * . . . # . . # # # . . . # # # # #
# * * . . # . . # . . . * . . . # # # #
# $ . . # . $ . . . . . . * . . . . $ #
# . . . . * . . . * * . . . . . * * * #
# # # # # # # # . . . # # # # # # # # #
# & . . . . * * . . . * * . . . . . & #
# # # # # # # # # # # # # # # # # # # #
