9 10
# # # # # # # # # #
# @ # $ . . # ! * #
# . * . * . * . * #
# . # . # . # . * #
# . * . * . * % * #
# . # . # . # . * #
# . * . * . * * * #
# . * . # . . & . #
# # # # # # # # # #
