19 19
# # # # # # # # # # # # # # # # # # #
# @ # . . . . . . . . . . . . . . . #
# . # . # # # # # # # # # # # # # . #
# . # . # . . . . . . . . . . . # . #
# . # . # . # # # # # # # # # . # . #
# . # . # . # . . . . . . . # . # . #
# . # . # . # . # # # # # . # . # . #
# . # . # . # . # & & & # . # . # . #
# . # . # . # . # & # & # . # . # . #
# . # . # . # . # ! # & # . # . # . #
# . # . # . # . # # # & # . # . # . #
# . # . # . # . & & & & # . # . # . #
# . # . # . # # # # # # # . # . # . #
# . # . # . . . . . . . . . # . # . #
# . # . # # # # # # # # # # # . # . #
# . # . . . . . . . . . . . . . # . #
# . # # # # # # # # # # # # # # # . #
# . . . . . . . . . . . . . . . . . #
# # # # # # # # # # # # # # # # # # #
