14 14
# # # # # # # # # # # # # #
# @ . . . . . . . . . . . #
# . * * * * * * * * * * . #
# . * . . . . . $ . . * . #
# . * . * * * * * * . * . #
# . * . * & * * & * . * . #
# . * . * * ! . * * . * . #
# . * . * * . . * * . * . #
# . * . * & * * & * . * . #
# . * . * * * * * * . * . #
# . * . . . . . . . . * . #
# . * * * * * * * * * * . #
# . . . . . . . . . . . $ #
# # # # # # # # # # # # # #
